24×18
########################
########################
########################
#########          #####
-      .  ######## #####
######.########### #####
###### ########### #####
###### ########### #####
###### ########### #####
###### ########### #####
###### ####        #####
######    . ######.#####
#########.######## #####
######### #######  .   A
######### ####### ######
#########         ######
########################
########################